{
    "map_tips":[
        [9,9,9,9,9,9,9,9,9,9,9,9,7,9,9,9,9,9,9,9,9,9,9,9,9],
        [9,1,1,1,9,1,1,1,1,1,1,1,1,1,1,1,1,1,1,1,1,1,1,1,9],
        [9,1,9,8,9,1,1,1,1,1,1,1,1,1,1,1,1,1,1,1,1,1,1,1,9],
        [9,1,9,1,1,1,1,1,1,1,1,1,1,1,1,1,1,1,1,1,1,1,1,1,9],
        [9,1,9,9,9,1,1,1,1,1,1,1,1,1,1,1,1,1,1,1,1,1,1,1,9],
        [9,1,1,1,1,1,1,1,1,1,1,1,1,1,1,1,1,1,1,1,1,1,1,1,9],
        [9,1,1,1,1,1,1,1,1,1,1,1,0,1,1,1,1,1,1,1,1,1,1,1,9],
        [9,1,1,1,1,1,1,1,1,1,1,1,1,1,1,1,1,1,1,1,1,1,1,1,9],
        [9,1,1,1,1,1,1,1,9,9,9,9,9,9,9,1,1,1,1,1,1,1,1,1,9],
        [9,1,1,1,1,1,1,1,1,1,9,1,1,1,9,1,1,1,1,1,1,1,1,1,9],
        [9,1,1,1,1,1,1,1,1,1,9,1,8,1,9,1,1,1,1,1,1,1,1,1,9],
        [9,1,1,1,1,1,1,1,1,1,9,1,1,1,9,1,1,1,1,1,1,1,1,1,9],
        [9,1,1,1,1,1,1,1,1,1,9,1,9,9,9,1,1,1,1,1,1,1,1,1,9],
        [9,1,1,1,1,1,1,1,1,1,9,1,1,1,9,9,9,1,9,1,1,1,1,1,9],
        [9,1,1,1,1,1,1,1,1,1,9,9,9,1,1,1,1,1,9,1,9,9,9,1,9],
        [9,1,1,1,1,1,1,1,9,1,1,1,1,1,9,1,9,1,9,1,1,1,9,1,9],
        [9,9,9,9,1,9,9,9,9,9,9,1,9,9,9,1,9,1,9,1,9,1,1,1,9],
        [9,1,1,1,1,9,1,1,1,9,8,1,9,1,1,1,9,1,1,1,9,1,9,9,9],
        [9,1,9,9,9,9,5,9,1,9,9,9,9,1,9,9,9,1,9,9,9,1,1,1,9],
        [9,1,1,1,1,9,1,9,1,1,1,1,9,1,9,1,1,1,1,1,9,9,9,1,9],
        [9,1,9,1,9,9,1,9,9,9,9,1,1,1,9,1,9,1,9,1,9,1,1,1,9],
        [9,1,9,1,5,1,1,9,1,5,9,1,9,9,9,1,9,1,9,1,1,1,9,1,9],
        [9,1,9,9,9,9,9,9,1,9,9,1,1,1,1,1,9,1,9,1,9,9,9,1,9],
        [9,1,1,1,1,1,1,1,1,1,1,1,1,9,1,1,1,1,9,1,1,1,1,8,9],
        [9,9,9,9,9,9,9,9,9,9,9,9,6,9,9,9,9,9,9,9,9,9,9,9,9]
    ]
}
